bg
PLAY-BG.png
star
4,12,20
map
0,0,0,1,2,5
0,1,0,1,2,6
0,2,0,1,1
0,3,1,1,1,4
0,4,0,1,1,5
0,5,1,1,1,4
1,2,0,2,1,4
1,4,0,2,1,5
2,0,1,1,1,h
2,5,0,1,1,p
3,0,0,1,1,4
3,1,0,1,1,s
3,2,0,1,1
3,3,0,1,1,m
3,4,0,1,1,6
3,5,0,1,1
4,0,0,2,1,5
4,2,1,1,1,4
4,3,0,2,1
4,5,1,1,1,6