bg
PLAY-BG.png
star
7,12,20
map
0,0,1,2,1
0,2,1,3,1
0,5,1,1,1,5

1,0,1,1,1
1,1,1,1,1,3
1,3,1,1,1
1,5,1,1,1,6

2,0,1,1,1,h
2,2,1,1,1,3
2,3,1,1,1,m
2,4,1,1,1,6
2,5,1,1,1,p

3,0,1,1,1,4
3,1,1,1,1,s
3,2,1,1,1,5
3,4,1,1,1,6
3,5,1,1,1,6

4,0,1,2,1
4,2,1,3,1,5
4,5,1,1,1
