bg
PLAY-BG.png

star
8,12,20
map
0,0,0,1,2,6
0,1,0,1,2,6
0,2,0,1,1,4
0,3,0,1,1,p
0,4,0,1,1,5
0,5,0,1,1,4

1,2,0,1,1,5
1,4,0,2,1,6

2,0,1,1,1,h
2,5,0,1,1,m

3,0,0,1,1,4
3,1,0,1,1
3,2,0,1,1,4
3,4,0,1,1,6
3,5,0,1,1,4

4,0,0,2,1,5
4,2,0,1,1,4
4,3,0,1,1,s
4,4,0,1,1,4
4,5,0,1,1,6

