bg
PLAY-BG2.png
star
39,38,44
map
0,0,1,1,2,m
0,1,0,1,3,4
0,2,1,3,1,s
0,5,1,1,1,4

1,2,1,1,1,4
1,5,1,1,1,6

2,0,1,1,1,5
2,3,0,1,1,5
2,4,1,1,1,4
2,5,1,1,1,5

3,2,1,1,1,4
3,3,1,1,1,3

4,0,1,1,1,p
4,1,0,2,1,5
4,4,1,2,1,h
