bg
PLAY-BG3.png
star
46,30,39
map
0,0,1,1,1,p
0,2,1,2,1
0,5,1,1,1,m

1,0,0,1,1,4
1,2,1,1,1,4
1,3,0,3,1,6

2,1,1,1,1,5
2,4,1,1,2
2,5,1,1,1,5

3,0,0,3,1
3,3,1,1,1,6
3,5,0,1,1,4

4,0,1,1,1,h
4,2,1,1,1
4,4,1,1,1,6
4,5,1,1,1,s
