bg
PLAY-BG4.png
star
36,30,39
map
0,0,1,1,1,m
0,3,1,2,1,6
0,5,1,1,1,4

1,0,0,1,1,4
1,1,1,1,1,6
1,3,1,1,1,6

2,1,1,1,3,5
2,2,0,2,2,p
2,4,1,1,1,6
2,5,1,1,1,5

3,0,0,1,1,4
3,4,1,1,1,4
3,5,1,1,2,h

4,0,1,1,1,s
4,2,1,1,1,6
4,3,1,1,1,5
