bg
PLAY-BG4.png
star
20,30,39
map
0,0,1,1,1,s
0,1,1,2,1,4
0,4,1,1,1,6

1,0,0,1,1,4
1,1,1,1,2,m
1,3,1,3,1,5

2,2,0,2,1,4
2,5,1,1,1,p

3,1,1,1,1,6
3,3,1,1,1,5
3,5,0,1,1,4

4,0,1,3,1,h
4,3,1,1,1,4
4,5,1,1,1,6
