bg
PLAY-BG3.png
star
33,30,39
map
0,0,1,1,2,m
0,2,1,2,1,6
0,4,1,2,2,h

1,1,1,1,2,6
1,2,1,1,1,4

2,0,1,1,1,5
2,4,1,1,3,6
2,5,1,1,1,5

3,0,1,2,2,p
3,2,1,1,1,6
3,3,1,1,2,4

4,5,1,1,1,s
