bg
PLAY-BG4.png
star
69,30,39
map
0,0,1,1,1,s
0,1,1,1,2,6
0,2,0,1,3,5
0,5,1,1,1,4

1,0,0,1,1,4
1,3,1,2,1,6

2,4,0,1,3,4
2,5,1,1,1,5

3,0,1,1,1,4
3,1,1,1,2,5
3,3,1,1,1,6

4,0,1,1,1,p
4,2,1,1,1,m
4,5,1,1,1,h
