bg
PLAY-BG4.png
star
70,30,39
map
0,0,1,1,1,5
0,2,0,1,2,6
0,3,1,1,1,m
0,4,0,1,3,5
0,5,1,1,1,h

1,0,0,1,1,4
1,1,1,1,1,5

2,1,1,1,1,6
2,2,1,1,1,4
2,3,1,1,2,p
2,5,1,1,1,6

3,0,1,1,1,5
3,1,0,2,1,6

4,0,1,1,1,s
4,1,1,2,1,5
4,3,1,1,1,4
4,4,1,1,1,6
4,5,0,1,1
