bg
PLAY-BG4.png
star
73,30,39
map
0,0,1,1,1,p
0,1,1,1,1,5
0,4,1,2,1,6

1,2,1,2,1,6
1,4,1,1,1,5

2,0,0,1,2,5
2,1,1,1,1,4
2,2,1,1,1,4
2,3,0,1,3,m
2,4,0,1,1,6
2,5,1,1,1,4

3,1,1,2,1,5

4,0,1,1,1,h
4,2,1,1,1,6
4,4,0,1,1,s
4,5,1,1,1,6
