bg
PLAY-BG3.png
star
55,30,39
map
0,1,1,1,1,4
0,2,1,1,1,6
0,4,0,1,2,6
0,5,1,1,1,h

1,0,1,1,1,4
1,1,0,1,2,5
1,2,1,1,1,4

2,0,1,1,1,m
2,3,1,1,3,6
2,5,1,1,1,5

3,0,0,2,1
3,2,1,1,1,4
3,4,1,1,2,5
3,5,0,1,1,4

4,0,1,1,1,p
4,5,1,1,1,s
