bg
PLAY-BG2.png
star
39,45,60
map
0,0,1,1,2,6
0,2,1,1,1,4
0,3,1,1,1,s
0,4,1,1,1
0,5,1,1,1,p

1,2,1,1,1,4
1,3,1,1,1,5
1,4,0,2,1,5

2,0,1,1,1
2,1,0,1,1
2,3,1,1,1,5

3,0,1,1,1,m
3,1,1,1,1,6
3,2,1,1,1,4
3,3,0,1,2
3,4,1,1,1
3,5,1,1,1

4,0,0,2,1
4,2,1,1,1,6
4,4,1,1,1,h
4,5,1,1,1,4
