bg
PLAY-BG3.png
star
20,38,44
map
0,0,1,1,2,6
0,2,1,2,1,h
0,5,1,1,1,4

1,2,1,1,1,4
1,5,1,1,1,6

2,0,1,1,1,5
2,2,0,2,1,5

3,2,1,2,2,m
3,4,1,2,1

4,0,1,1,1,s
4,5,1,1,1,p
