bg
PLAY-BG.png
star
14,18,25
map
0,0,1,2,1
0,2,1,1,1
0,3,1,1,1,6
0,4,1,2,1,4

1,0,1,1,1,m
1,2,0,2,1,h
1,5,1,1,1,s

2,0,1,1,2,3
2,1,1,1,2,4
2,2,1,2,1,5
2,4,1,2,1,5

3,3,1,1,1,3
3,4,1,2,1,6

4,0,1,2,1,4
4,2,1,2,1,p
4,5,1,1,1,6
