bg
PLAY-BG3.png
star
27,30,39
map
0,0,1,1,2,s
0,1,1,1,3,5
0,2,1,2,1,h
0,5,1,1,1,4

1,2,1,1,1,4
1,3,1,2,1,5
1,5,1,1,1,6

2,0,1,1,1,4
2,4,1,1,3

3,2,1,1,1,5
3,3,1,1,2,4

4,0,1,1,1,p
4,1,1,1,1,6
4,5,1,1,1,m
